############
#          #
#          #
# #        #
#       #  #
#     #    #
# ##   #   #
#  #    # ##
# #        #
# #        #
# #   #    #
############